; 1:
    #####           
    #   #           
    #$  #           
  ###  $##          
  #  $ $ #          
### # ## #   ###### 
#   # ## #####  ..# 
# $  $          ..# 
##### ### #@##  ..# 
    #     ######### 
    #######         

; 2:
   ##########   
   #..  #   #   
   #..      #   
   #..  #  #### 
  #######  #  ##
  #            #
  #  #  ##  #  #
#### ##  #### ##
#  $  ##### #  #
# # $  $  # $  #
# @$  $   #   ##
#### ## ####### 
   #    #       
   ######       

